26 24 24 8 22 22 22 22 7 8 25 24 1 24 24 
24 24 24 8 22 22 22 22 22 8 24 24 1 5 24 
24 24 24 7 8 22 22 22 22 8 24 24 1 24 24 
24 24 24 24 7 7 7 8 22 8 24 24 1 24 25 
24 24 5 24 24 24 24 7 7 7 24 25 1 24 24 
1 1 1 1 1 1 24 24 24 24 24 24 1 24 5 
26 24 24 24 24 1 1 1 1 1 1 1 1 1 1 
24 24 24 24 24 24 24 24 24 24 24 24 24 24 24 
3 3 24 24 24 24 26 24 24 24 24 24 24 24 24 
0 3 3 24 24 24 24 24 24 24 24 24 24 25 24 
0 0 3 3 3 3 3 3 3 3 3 3 3 3 3 
3 3 3 3 24 24 24 25 24 24 3 3 3 3 24 
