22 22 22 22 22 22 22 22 22 22 22 22 22 22 22 22 22 
22 22 22 22 22 22 22 22 22 22 22 22 22 22 22 22 22 
22 22 22 20 23 17 17 17 23 17 17 17 23 18 22 22 22 
22 22 22 21 16 16 16 16 16 16 16 16 16 19 22 22 22 
22 22 22 21 16 16 16 16 16 16 16 16 16 19 22 22 22 
22 22 22 21 16 16 16 16 16 16 16 16 16 19 22 22 22 
22 22 22 21 16 16 16 16 16 16 16 16 16 19 22 22 22 
22 22 22 21 16 16 16 16 16 16 16 16 16 19 22 22 22 
22 22 22 21 16 16 16 16 16 16 16 16 16 19 22 22 22 
22 22 22 21 16 16 16 16 16 16 16 16 16 19 22 22 22 
22 22 22 21 16 16 16 16 16 16 16 16 16 19 22 22 22 
22 22 22 21 16 16 16 16 16 16 16 16 16 19 22 22 22 
