30 30 30 30 30 30 30 30 30 30 40 40 40 40 29 40 40 
30 30 30 30 30 30 30 30 30 30 40 40 40 36 29 36 40 
39 30 30 30 30 30 39 30 30 30 40 40 40 37 29 37 40 
29 29 29 29 29 29 29 29 29 29 29 29 29 29 29 40 40 
39 30 29 30 30 30 39 30 30 30 40 40 40 34 29 34 40 
30 30 29 30 30 30 30 30 30 30 40 40 40 36 29 36 40 
30 30 29 30 30 30 30 30 30 30 40 40 40 37 29 37 40 
30 30 29 30 30 30 30 30 30 30 40 40 40 40 29 40 40 
39 30 29 34 30 30 39 30 30 34 40 40 40 34 29 34 40 
29 29 29 29 29 29 29 29 29 29 29 29 29 29 29 29 29 
39 30 30 34 30 30 39 30 30 34 30 30 30 34 30 34 30 
30 30 30 30 30 30 30 30 30 30 30 30 30 30 30 30 30 
