25 24 24 14 1 24 26 24 24 24 24 5 24 25 24 
24 24 24 24 1 24 24 24 24 26 24 1 1 1 1 
24 24 24 24 1 24 24 25 24 24 24 1 24 24 24 
24 25 24 14 1 24 24 24 24 24 24 1 24 24 24 
24 24 24 24 1 5 24 15 24 24 24 1 24 14 24 
24 24 24 24 1 1 1 1 1 1 1 1 1 1 1 
5 24 15 24 1 24 25 14 24 24 24 1 24 24 25 
1 1 1 1 1 24 24 24 24 24 24 1 15 24 24 
14 24 14 24 1 24 24 25 24 24 24 1 24 24 24 
26 24 24 24 1 24 24 24 24 24 14 1 24 25 24 
24 24 24 24 1 5 24 24 24 26 24 1 14 24 24 
24 26 24 24 1 24 26 24 24 24 24 1 24 24 24 
