24 15 24 24 24 24 26 24 24 24 1 3 3 24 24 
1 1 1 1 1 1 1 1 1 1 1 10 10 1 1 
24 24 24 14 24 24 24 24 24 14 24 3 3 1 24 
25 24 24 24 24 24 25 24 24 24 24 3 3 1 24 
24 24 24 24 24 24 24 24 25 24 24 3 3 1 5 
1 1 1 1 1 1 3 3 3 3 3 3 3 1 24 
14 24 24 24 24 1 3 3 3 3 3 3 3 1 24 
24 24 24 24 24 1 3 3 3 3 3 3 3 1 24 
24 24 24 24 24 1 3 3 3 3 3 3 3 1 5 
24 24 24 24 24 1 3 3 3 3 3 3 3 1 24 
24 25 24 24 15 1 3 3 3 3 3 3 3 1 26 
24 24 24 24 24 1 3 3 3 3 3 3 3 1 24 
