4 4 24 24 24 26 24 24 24 24 1 15 24 24 24 
4 24 24 24 24 24 24 24 24 24 1 24 24 24 24 
24 24 24 24 15 24 24 24 24 24 1 24 24 24 24 
1 1 1 1 1 1 1 1 1 1 1 24 24 26 24 
24 24 24 1 24 24 24 24 24 24 1 24 24 24 24 
25 24 24 1 24 24 24 24 24 24 1 24 24 24 24 
24 24 24 1 24 24 24 25 24 24 1 5 24 24 24 
15 24 24 1 24 24 24 24 24 24 1 3 3 3 3 
1 1 1 1 24 24 27 24 24 24 1 3 3 3 3 
24 24 24 24 24 24 24 24 24 24 1 3 3 24 25 
25 24 24 24 24 24 24 24 24 24 1 3 3 24 24 
24 24 24 24 24 26 24 24 24 24 1 3 3 24 24 
