24 24 24 24 1 24 24 24 24 24 24 24 24 24 24 24 24 
24 24 24 24 1 24 24 24 24 25 24 24 24 24 24 24 25 
24 5 24 26 1 26 24 24 24 24 5 24 24 26 24 24 24 
1 1 1 1 1 1 1 1 1 1 1 1 1 1 1 1 1 
24 24 24 24 1 24 24 24 24 24 24 24 14 24 24 24 24 
24 25 24 24 1 24 24 24 24 24 24 24 24 24 24 24 24 
24 24 24 5 1 24 28 24 24 24 24 24 24 24 24 24 25 
24 24 24 24 1 24 24 24 24 24 25 24 5 24 24 24 24 
24 24 24 24 1 1 1 1 1 1 1 1 1 1 1 1 1 
24 24 24 24 1 24 24 24 24 24 24 24 24 24 24 24 24 
25 24 24 24 1 24 24 24 24 24 24 24 24 24 24 26 24 
24 24 24 24 1 15 24 24 25 24 24 24 25 24 24 24 24 
