30 30 30 30 30 30 30 30 39 30 30 41 38 40 38 40 38 
39 30 30 30 30 39 30 30 30 30 30 41 40 40 40 40 40 
30 30 39 30 30 30 30 30 30 30 30 41 40 36 40 36 40 
30 30 30 30 30 30 30 39 30 30 30 41 40 37 40 37 40 
30 31 30 30 30 30 30 31 30 30 30 41 40 40 40 40 40 
29 29 29 29 29 29 29 29 29 29 29 29 29 29 29 29 29 
30 30 30 30 32 33 30 30 29 40 40 34 40 40 34 40 34 
30 30 30 39 30 30 30 30 29 40 40 40 40 40 40 40 40 
30 30 30 30 30 39 30 30 29 40 40 35 40 40 40 40 40 
30 30 30 30 30 30 30 30 29 40 40 40 40 40 40 40 40 
30 39 30 30 30 30 30 30 29 40 40 40 40 40 40 40 40 
30 30 30 30 30 30 30 30 29 40 40 40 40 40 40 40 40 
