30 30 30 30 30 30 76 30 30 76 30 30 30 30 30 30 30 
63 63 63 63 63 63 80 30 30 77 63 63 63 63 63 63 63 
64 64 64 64 64 64 81 29 29 78 64 64 64 64 64 64 64 
65 65 65 65 65 65 82 29 29 79 65 65 65 65 65 65 65 
30 44 30 44 30 44 30 29 29 30 44 30 44 30 44 30 44 
30 30 30 30 30 30 86 29 29 87 30 30 30 30 30 30 30 
30 57 58 30 30 30 30 29 29 30 30 30 30 30 31 32 30 
30 60 59 30 30 30 86 29 29 87 30 62 30 30 34 33 30 
29 29 29 29 29 29 29 29 29 29 29 29 29 29 29 29 29 
30 39 39 30 30 30 86 29 29 87 30 30 30 30 39 39 30 
30 30 30 30 30 30 30 29 29 30 30 30 30 30 30 30 30 
30 44 30 44 30 44 86 29 29 87 44 30 44 30 44 30 44 
