30 30 30 30 30 30 30 30 30 30 30 30 30 30 30 30 30 
30 30 30 30 30 103 104 107 108 111 112 30 30 30 30 30 30 
30 30 30 30 30 105 106 109 110 113 114 30 30 30 30 30 30 
30 30 30 30 30 115 116 119 120 123 124 30 30 30 30 30 30 
30 30 30 30 30 117 118 121 122 125 126 30 30 30 30 30 30 
30 30 30 30 30 127 128 131 132 135 136 30 30 30 30 30 30 
30 30 30 30 30 129 130 133 134 137 138 30 30 30 30 30 30 
29 29 29 29 29 29 29 29 29 29 29 29 29 29 29 29 29 
30 30 30 30 30 30 30 30 30 30 30 30 30 30 30 30 30 
30 30 30 30 30 30 30 30 30 30 30 30 30 30 30 30 30 
30 30 30 30 30 30 30 30 30 30 30 30 30 30 30 30 30 
30 30 30 30 30 30 30 30 30 30 30 30 30 30 30 30 30 
